11111111
100C0001
10E00111
1000P1C1
11111111
