11111101
100C0001
10000101
1000P001
11111111
