11111101
100C0001
10E0001
1000P001
11111111
