11111101
100C0001
10E00101
10000001
11111111
