11111101
10000001
10E00101
1000P001
11111111
