1111111
1P00001
10E0111
100C1C1
1111111
