111111111111111111111111
100000000000000000000001
100C000C00C000C00000P001
10C0C00CC0C00C0C00000001
10CCC00C0CC00CCC0000E001
1C000C0C00C0C000C0000001
100000000000000000000001
111111111111111111111111
