111111111111111111111111
100000000000000000000001
100C000C00C000C00010P001
10C0C00CC0C00C0C00100001
10CCC00C0CC00CCC0010E001
1C000C0C00C0C000C0100001
100000000000000000000001
111111111111111111111111
