11111111111111111
10P001C0001C000C1
11110111101110111
10000000000000001
111101110111C1101
1C000100C0011C001
1111010C0C0111101
1C1101C0E0C111101
10C1010C0C011C1C1
10100100C00110111
101111110111C0001
101C1000010C11101
10101011110111101
10000000000000001
11111111111111111
