1111111
1P00001
10E0001
100C0C1
1111111

